16
15
EEEEEE====EEEEEE
EEEEEE=XX=EEEEEE
EEEEEE=..=EEEEEE
EEEEEE=..=EEEEEE
EEEEEE=..=EEEEEE
EEEEEE=..=EEEEEE
EEEEEE=..=EEEEEE
EEEEEE=..=EEEEEE
EEEEEE=..=EEEEEE
EEEEEE=..=EEEEEE
EEEEEE=..=EEEEEE
EEEEEE=..=EEEEEE
EEEEEE=RR=EEEEEE
EEEEEE=.P=EEEEEE
EEEEEE====EEEEEE